########
#      #
#      #
#      #
#  C   #

       #
########