########
#      #
#      #
#      #
#  C   #
       #
#      #
########